25 25
########### #############
#                       #
#  ==  ==  ==           #
#                       #
#                       #
#  ==  ==  ==           #
#                       #
#                       #
#  ==  ==  ==           #
#                       #
#                       #
#  ==  ==  ==           #
#                       #
#                       #
#  ==  ==  ==           #
#                       #
#                       #
#                       #
###..####################
#.......................#
#.......................#
#.......................#
#.......................#
#.......................#
#########################