25 25
#########################
#..........#............#
#.......................#
#..........#............#
#..........#............#
############............#
#                       #
#                       #
#                       #
#                       #
#                       #
#  ==   ==     ==   ==  #
#                       #
#  ==   ==     ==   ==  #
#                       #
#  ==   ==     ==   ==  #
#                       #
#  ==   ==     ==   ==  #
#                       #
#  ==   ==     ==   ==  #
#                       #
############ ############
*************************
*************************
*************************